reccodmission	recommissioned	re-admission	comission
unpair	unfair	unpaid	unai
oconomic	zoonotic	oconee	oconomowoc	oncologic	cnmi
accidnts	accident	accidents	accidental	accidently
succes	success	succeeds	succes
enthousiastic	enthusiastic	enthusiasts	enthusiast
produse	produce	produces	prose	prods	profuse
tecnologycal	technology	technological	technologically
upto	upton	upto	uspto
poisioning	poisoning	positioning	provisioning
competitiors	competitors	competitor	competitions
riks	risk	ricks	rikers	rinks	riklis
definations	definitions	designations	defintion
vivd	vivid	viv	vid	vvd	viavid
tradind	trading	train	trained	tradewinds
materail	material	materials	maternal	materiel	matera
useig	using	ushering	uselding
thoese	these	thoresen	thos
concludsion	conclusion	conclusions	concussion	concluding
controll	control	controlled	controller	controll
thise	this	thies	thie	thse
banefit	bane	bani	befit	banfi
fatct	fat-cat	fatcats	fatcat
condamnation	condemnation	condensation	condemnations
forula	formula	formulas	forlan	formulae
thingh	things	thing	thin	thigh	thingy
migth	might	mitch	mighty	mirth	mightn
healtheir	health	healthier	heather	healer
everythingfor	everything	everthing	eveything
beleif	belief	beliefs	beli
resourses	resources	resource	resourced	recourses
advantanges	advantage	advantages	advantageous
diguise	digits	digs	digitise	digi
additionly	additional	addition	additionally	additionality
opportunnity	opportunity	opportunist	oportunity
urself	yourself	ourself	oursel
rebelion	rebellion	rebellions	rebellin	rebelo
chioce	choice	choices	chic	chie
consdiered	considered	consider	considerate
travals	travels	travails	travail	travoltas
inturn	intern	intron	intune	intuniv
inly	inlay	inlays	inl
everydays	everyday	every-day	everday
specilaized	specialized	specializes	specialised	specialize
runned	runner	ruined	runnymede	rune
allive	alive	allie	allusive
anylonger	anyone	anyones	anlong
explantion	explanation	explanations	explaination
insearch	search	insert	insect	insead	inserm
advertisments	advertisements	advertisment	advertisments
referencial	reference	referencing	referenda	referential
processure	process	pressure	procedure	processes	processed
whis	whips	whisk	whims	whigs	whist
populization	population	populations	popularization
prodcut	products	product	produ
beleived	believed	beleive	beleived
backgrounging	background	backgrounds	backgrounder
difinetly	definitely	divinely	diffidently
addtion	addition	addison	addaction
anyhting	anything	anying	anthing
variatons	variations	variation	variants
interfer	interfere	interfering	interfered	interferes	interferon
eloctronics	electronics	electrics	elocution
undestanded	understand	understands	understandable	underhanded
easially	easily	basically	easi
assestments	assessments	assesses	assesment
regared	regarded	regard	reared
knowlkedge	knowledge	knowledgable	knowlege
successs	success	successes	successors
represant	represents	represent	represented
actractive	active	attractive	activate	accretive
nood	noodle	snood	noorda	noodly
focuss	focus	focuses	focussed	focusses
decreace	decrease	decreased	decree	decreases	decreed
magagine	magazine	magazines	maggie	magaziner
knowedge	knowledge	knowledgable	knowlege
relativley	relatively	relatives	relative
wheter	whether	wheater	wether	whetter
convience	convince	convene	conveyance
extremly	extremely	extremity	extremly
espacilly	especially	epically	especialy
becasuse	because	becasue	becaue	becase
carrir	carrier	carriers	carriere	carriker	carri
actualy	actually	actual	actualy
calaberating	calabria	calabrian	calibrating
simpley	simply	simple	simpler	simplex	simley
remanticism	remains	romanticism	remics
pannel	panel	pannell	panne
diferrent	different	diferent	differnt
reguire	require	regier	regularise	regularize
sucject	subject	sucre	suchet
diostract	distracted	distract	distracts
tremeadous	tremendous	tremendously	tremadog
dirive	dire	dirie	idrive
tecnologies	technologies	technologist	technologie
desappear	disappear	disappears	desparate
genarally	generally	gnarly	genially	genalyn
profesor	professor	professors	prosor
abandant	abandon	abandonment	abadan
greatt	great	garett	gretta
