reccodmission	recommissioned	comission	re-admission
unpair	unpaid	unfair	unai
oconomic	oconomowoc	oncologic	cnmi	oconee	zoonotic
accidnts	accidents	accident	accidently	accidental
succes	succes	success	succeeds
enthousiastic	enthusiastic	enthusiast	enthusiasts
produse	produces	produ	prods	produce	profuse
tecnologycal	technological	technology	technologically
upto	upto	upton	uspto
poisioning	poisoning	provisioning	positioning
competitiors	competitors	competitor	competitions
riks	rinks	ricks	risk	riklis	rikers
definations	defintion	definitions	designations
vivd	vivid	vvd	vid	viv	viavid
tradind	trading	tradewinds	trained	train
materail	material	materials	matera	materiel	maternal
useig	uselding	ushering	using
thoese	these	thoresen	thos
concludsion	conclusion	conclusions	concluding	concussion
controll	controll	control	controller	controlled
thise	this	thie	thies	thse
banefit	banfi	befit	bane	bani
fatct	fatcat	fatcats	fat-cat
condamnation	condemnation	condemnations	condensation
forula	formula	formulae	formulas	forlan
thingh	thing	thigh	thingy	thin	things
migth	might	mightn	mighty	mirth	mitch
healtheir	healthier	heather	healer	health
everythingfor	everything	everthing	eveything
beleif	belief	beliefs	beli
resourses	recourses	resource	resources	resourced
advantanges	advantages	advantage	advantageous
diguise	digitise	digi	digs	digits
additionly	additionally	addition	additional	additionality
opportunnity	opportunity	oportunity	opportunist
urself	ourself	yourself	oursel
rebelion	rebellion	rebellions	rebelo	rebellin
chioce	choice	chie	chic	choices
consdiered	considered	consider	considerate
travals	travails	travail	travels	travoltas
inturn	intune	intron	intern	intuniv
inly	inlay	inlays	inl
everydays	everyday	every-day	everday
specilaized	specialized	specialize	specialised	specializes
runned	runnymede	runner	rune	ruined
allive	allie	alive	allusive
anylonger	anyone	anlong	anyones
explantion	explanation	explanations	explaination
insearch	search	inseam	inserm	insead	insect
advertisments	advertisments	advertisment	advertisements
referencial	referential	referencing	referenda	reference
processure	pressure	process	processor	processed	processes
whis	whist	whisk	whirs	whigs	whims
populization	popularization	population	populations
prodcut	product	products	produ
beleived	beleived	beleive	believed
backgrounging	background	backgrounds	backgrounder
difinetly	definitely	diffidently	divinely
addtion	addaction	addition	addison
anyhting	anything	anying	anthing
variatons	variations	variation	variants
interfer	interfere	interferon	interferes	interfered	interferons
eloctronics	elocution	electronics	electrics
undestanded	understand	underhanded	understands	understandable
easially	easily	easi	basically
assestments	assessments	assesment	assesses
regared	regard	reared	regarded
knowlkedge	knowledge	knowlege	knowledgable
successs	successes	success	successors
represant	represent	represents	represented
actractive	attractive	active	activate	accretive
nood	noodly	noodle	snood	noorda
focuss	focuses	focus	focusses	focussed
decreace	decree	decrease	decreases	decreased	decrees
magagine	magazine	maggie	magaziner	magazines
knowedge	knowledge	knowlege	knowledgable
relativley	relatively	relative	relatives
wheter	whetter	whether	wheater	wether
convience	convene	convince	conveyance
extremly	extremly	extremely	extremity
espacilly	especially	epically	especialy
becasuse	becasue	becase	becaue	because
carrir	carrier	carri	carreiro	carriere	carriker
actualy	actualy	actually	actual
calaberating	calabrian	calibrating	calabria
simpley	simple	simply	simley	simples	simplex
remanticism	romanticism	remains	remics
pannel	pannell	panne	panel
diferrent	diferent	different	differnt
reguire	regier	require	regularize	regularise
sucject	subject	suchet	sucre
diostract	distract	distracts	distracted
tremeadous	tremendous	tremendously	tremadog
dirive	dirie	idrive	dire
tecnologies	technologies	technologie	technologist
desappear	disappear	disappears	desparate
genarally	genially	generally	genalyn	gnarly
profesor	professor	professors	prosor
abandant	abandon	abadan	abandonment
greatt	great	gretta	garett
